          NO       ./assets/wall.xpm
F 220,100,03
SO ./assets/wall1.xpm





        111111111111111111111111111
        1000000000110000000000001
        1011000001110000000000001
        1001000000000000000000001
111111110011000001110000000000001
10000000001101111111110111111111111
1111011111111     1011100000010001
1111011111111     111101010010001
1100000011011     1011100000010001
1000000000001     1001100000010001
1000000000000111111111101010010001
11000001110101011111011110N0111111
11110111 110101 101111010001
11111111 1111111 111111111111


WE ./assets/wall2.xpm
EA ./assets/wall3.xpm



C 225,30,0
