     NO    ./assets/wall.xpm 


F     255     ,      0    , 80  

SO ./assets/wall1.xpm

WE ./assets/wall2.xpm 
EA ./assets/wall3.xpm

C +0    , +1, 160





        
        111111111111111111111111111
        1000000000110000000000001
        101100000111000000000001
        1001000000000000000000001
111111110011000001110000000000001
10000000001101111110000111111111111
1111011111111     1011000000010001
1111011111111     111100010010001
1100000011011     1000000000010001
1000000000001     100110000S010001
1000000000000111111101101010010001
1100000111010000000001111000111111
11110111 1101011101111010001
11111111 1111111 111111111111