     NO       ./wall.xpm
F 255,0,0
SO ./wall1.xpm



WE ./wall2.xpm
EA ./wall3.xpm



C +0    ,  0   ,255



11111
11001
10001
10001
10001
10001
10101
10001
10S01
10001
10001
10001
10001
11011
11111