     NO       ./assets/wall.xpm            
F             +030              ,    250    , 50            
SO     ./assets/wall1.xpm     

WE ./assets/wall2.xpm
EA ./assets/wall3.xpm     



C +0    ,  0   , 255  

     11111     
     11001
     10001
     10001                    
     10101
     10001
     10101   
     10001                
     10001
     10001       
     10001
     10N01
     10001
     10001
     11011
     11111